{
  "name": "Level 3",
  "map": [
    "..................",
    ".TT...........TT..",
    ".TT...........TT..",
    "....GGGG..........",
    "....GGGG..........",
    "..................",
    ".TT...............",
    ".TT...............",
    "..................",
    ".........GGGG.....",
    ".........GGGG.....",
    ".................."
  ]
}
