{
  "name": "Level 3",
  "mowPattern": "rings",
  "map": [
    "..................",
    ".GG..TT..BBB..GG..",
    ".GG..TT.......GG..",
    "..................",
    "..................",
    "...TT..GG..BBB..TT",
    "...TT..GG.......TT",
    ".................."
  ]
}
