{
  "name": "Level 1",
  "map": [
    "..................",
    "..BBBB..GG..BBB...",
    "........GG........",
    "..................",
    "..GG..............",
    "..GG...TT....TT...",
    ".......TT....TT...",
    ".................."
  ]
}
