{
  "name": "Level 2",
  "mowPattern": "stripe",
  "map": [
    "..................",
    "..TT....GG.....TT.",
    "..TT....GG.....TT.",
    "..........BBBBB...",
    ".TT.GGGG..........",
    ".TT.GGGG..........",
    "..BBBBB...........",
    ".........GGGG..TT.",
    ".........GGGG..TT.",
    ".....BB...........",
    "..TT..........TT..",
    "..TT..........TT.."
  ]
}
