{
  "name": "Level 1",
  "mowPattern": "checker",
  "map": [
    "..................",
    "..BBB..TT..GG..BBB",
    ".......TT..GG.....",
    "..................",
    "..................",
    "..GG..TT..BBB..TT.",
    "..GG..TT.......TT.",
    ".................."
  ]
}
