{
  "name": "Level 4",
  "map": [
    "..................",
    ".TT...............",
    ".TT...............",
    "..................",
    "............PPPP..",
    ".TT.........PPPP..",
    ".TT.........PPPP..",
    ".................."
  ]
}
