{
  "name": "Level 3",
  "mowPattern": "rings",
  "map": [
    "..................",
    "..............TT..",
    ".TT...........TT..",
    ".TT.GGGG..........",
    "....GGGG.TT.......",
    "...BB....TT.......",
    ".TT...........GG..",
    ".TT...........GG..",
    "........BBBBB.....",
    ".GG..TT..GGGG.....",
    ".GG..TT..GGGG.....",
    ".....BB..........."
  ]
}
