{
  "name": "Level 2",
  "mowPattern": "stripe",
  "map": [
    "..................",
    "..TT..BBB..GG..TT.",
    "..TT.......GG..TT.",
    "..................",
    "..................",
    "..GG..TT..BBBB..GG",
    "..GG..TT........GG",
    ".................."
  ]
}
