{
  "name": "Level 3",
  "mowPattern": "rings",
  "map": [
    "........TT....",
    "..BBB...TT....",
    "..............",
    "..............",
    "....BBBB......",
    "..............",
    "..........GG..",
    "..TT..GG..GG..",
    "..TT..GG......",
    "..............",
    "...........TT.",
    "...........TT."
  ]
}
