{
  "name": "Level 2",
  "mowPattern": "stripe",
  "map": [
    "....GG........",
    "....GG..BBB...",
    "..............",
    "..............",
    ".......TT..TT.",
    ".......TT..TT.",
    ".BBBB.........",
    "..............",
    "........TT....",
    ".GG.....TT....",
    ".GG...........",
    ".............."
  ]
}
