{
  "name": "Level 3",
  "mowPattern": "rings",
  "map": [
    "..................",
    ".GG..TT.......GG..",
    ".GG..TT..BBB..GG..",
    "..................",
    "..................",
    "...TT........TT...",
    "...TT..BBBB..TT...",
    ".................."
  ]
}
