{
  "name": "Level 1",
  "map": [
    ".........BBB..",
    "..............",
    "..TT..........",
    "..TT.......GG.",
    "...........GG.",
    "..............",
    "..............",
    "......GG......",
    "......GG......",
    "..............",
    "...........TT.",
    "....BBBB...TT."
  ]
}
