{
  "name": "Level 3",
  "map": [
    "..................",
    "..............TT..",
    ".TT...........TT..",
    ".TT.GGGG..........",
    "....GGGG.TT.......",
    ".........TT.......",
    ".TT...........GG..",
    ".TT...........GG..",
    "..................",
    ".GG..TT..GGGG.....",
    ".GG..TT..GGGG.....",
    ".................."
  ]
}
