{
  "name": "Level 1",
  "map": [
    "..................",
    "..................",
    ".TT...............",
    ".TT...............",
    "..................",
    "..............GG..",
    "..............GG..",
    "..................",
    "......TT..........",
    "......TT..........",
    "..................",
    ".................."
  ]
}
