{
  "name": "Level 2",
  "map": [
    "..................",
    "..TT....GG.....TT.",
    "..TT....GG.....TT.",
    "..................",
    ".TT..GGGG.........",
    ".TT..GGGG.........",
    "..................",
    ".........GGGG..TT.",
    ".........GGGG..TT.",
    "..................",
    "..TT..........TT..",
    "..TT..........TT.."
  ]
}
