{
  "name": "Level 2",
  "map": [
    "..................",
    "..TT..............",
    "..TT..............",
    "..................",
    ".....GGGG.........",
    ".....GGGG.........",
    "..................",
    ".........GGGG.....",
    ".........GGGG.....",
    "..................",
    "..TT..........TT..",
    "..TT..........TT.."
  ]
}
