{
  "name": "Level 1",
  "map": [
    "...........TT.....",
    "...........TT..GG.",
    ".TT............GG.",
    ".TT....BB.........",
    ".........TT.......",
    ".........TT...GG..",
    "..............GG..",
    "........BBBBB.....",
    "......TT..........",
    "..GG..TT..........",
    "..GG.....BB.......",
    ".................."
  ]
}
