{
  "name": "Level 1",
  "map": [
    "...........TT.....",
    "...........TT..GG.",
    ".TT............GG.",
    ".TT...............",
    ".........TT.......",
    ".........TT...GG..",
    "..............GG..",
    "..................",
    "......TT..........",
    "..GG..TT..........",
    "..GG..............",
    ".................."
  ]
}
