{
  "name": "Level 2",
  "mowPattern": "stripe",
  "map": [
    "..................",
    "......TT.....BBBB.",
    "..TT..TT..........",
    "..TT..............",
    "..........GG......",
    "......GG..GG...TT.",
    ".BBB..GG.......TT.",
    ".................."
  ]
}
